
4 4 4 4 4 4 4 4 4 4 4 4 4 4 4 4 4 4 4 4 4 4 4 4 4 4 4 4 4 4 4 4 4 4 4 4 4 4 4 4 4 4 4 4 4 4 4 4 4 4 
4 0 0 0 0 0 0 0 0 0 0 0 4 4 4 4 4 0 0 0 0 0 0 0 0 0 0 0 0 0 0 0 0 0 0 0 0 0 0 0 0 0 0 0 4 0 0 0 0 4 
4 0 0 0 0 0 0 0 0 0 0 0 4 4 4 4 4 4 4 4 0 0 0 0 0 0 0 0 0 3 3 3 3 3 3 3 3 3 3 0 0 4 0 4 4 4 0 0 0 4 
4 0 0 0 0 0 0 0 0 0 0 0 0 4 4 4 4 4 0 4 0 0 0 0 0 1 1 1 1 7 1 1 1 1 0 0 0 0 0 0 0 4 4 4 4 4 4 4 0 4 
4 0 0 0 3 3 3 3 3 3 3 3 0 4 0 4 4 4 0 4 4 4 0 0 0 1 12 12 12 7 12 12 12 1 0 0 4 0 0 0 0 0 0 0 0 4 4 0 0 4 
4 0 0 0 0 0 0 0 0 0 0 3 3 0 0 4 4 4 0 4 4 0 0 0 0 1 12 12 12 7 12 12 12 1 0 0 4 4 4 4 0 0 0 0 0 0 0 0 0 4 
4 0 0 0 4 4 4 4 4 0 0 0 3 3 0 0 0 0 0 4 0 0 0 0 0 1 12 12 12 7 12 12 12 1 0 0 0 0 0 4 0 0 4 4 4 0 4 4 4 4 
4 0 0 0 4 4 4 4 4 4 0 0 0 3 3 0 4 4 4 4 4 4 0 0 0 1 12 12 7 7 7 12 12 1 0 0 4 4 4 4 0 0 0 4 4 4 4 0 0 4 
4 0 3 4 4 4 0 4 4 4 4 4 4 0 3 0 4 4 4 4 0 4 4 0 0 7 7 7 7 7 7 7 7 7 0 0 4 4 4 4 0 0 0 4 4 4 4 4 0 4 
4 0 3 4 4 0 0 0 4 4 4 4 4 0 0 0 4 4 4 4 4 0 4 0 0 1 12 12 7 7 7 12 12 1 0 0 4 4 4 4 0 0 0 0 0 0 0 4 0 4 
4 0 3 3 4 0 0 0 4 4 4 0 0 0 0 0 0 0 4 4 4 4 4 0 0 1 12 12 8 7 12 12 12 1 0 0 4 4 4 0 0 0 4 4 4 4 0 0 0 4 
4 0 4 3 0 0 0 0 4 0 0 0 0 0 3 0 0 0 4 0 0 4 4 0 0 1 12 12 12 7 12 12 12 1 0 0 0 4 4 4 0 0 4 4 4 4 4 4 4 4 
4 0 4 4 0 0 0 0 4 0 0 1 1 1 7 1 1 1 4 0 0 0 0 0 0 1 12 12 12 7 12 12 12 1 0 0 0 4 4 4 4 0 4 4 4 4 0 4 4 4 
4 0 4 4 4 4 4 4 4 4 0 1 12 12 7 12 12 1 4 4 4 4 4 0 0 1 1 1 1 7 1 1 1 1 0 0 4 4 4 4 4 0 4 4 4 0 0 3 3 4 
4 0 4 4 4 4 4 4 4 4 0 1 12 12 7 12 12 1 0 0 4 4 4 0 0 0 0 0 0 3 0 0 0 0 0 0 4 4 4 4 4 0 4 4 4 0 0 3 5 4 
4 0 4 4 4 4 4 4 4 4 0 1 12 7 7 7 8 1 0 0 0 0 4 0 0 0 0 0 0 3 0 0 4 4 4 4 4 4 4 4 0 0 4 4 0 0 4 5 5 4 
4 0 4 4 4 4 0 0 4 4 0 7 7 7 7 7 7 7 0 0 0 3 3 3 3 3 3 3 3 3 0 4 4 0 0 0 0 0 0 0 0 0 4 0 0 4 4 5 5 4 
4 0 0 4 4 0 0 0 0 4 0 1 12 7 7 7 12 1 0 0 0 0 0 0 0 0 0 0 0 0 0 4 4 4 4 4 4 0 0 0 4 4 4 0 4 4 3 5 5 4 
4 0 0 4 4 0 4 4 4 4 0 1 12 12 7 12 12 1 0 0 0 0 0 0 0 0 0 0 0 0 0 4 4 4 4 4 4 0 0 0 0 0 0 4 4 4 5 5 5 4 
4 0 0 4 4 4 4 4 4 0 0 1 12 12 7 12 12 1 0 0 0 4 4 4 4 4 0 0 0 4 4 4 4 4 4 4 0 0 0 4 4 4 0 4 4 0 5 5 5 4 
4 0 4 4 0 4 4 4 4 0 0 1 1 1 7 1 1 1 0 0 4 4 4 4 4 4 0 0 0 4 4 4 4 4 0 4 0 0 4 4 4 4 4 4 0 3 5 5 5 4 
4 0 0 0 0 4 4 0 0 0 0 0 0 0 0 0 0 0 0 0 4 4 4 4 4 4 0 0 0 4 4 4 4 4 4 4 0 0 4 4 4 4 0 0 3 3 5 5 5 4 
4 0 0 0 0 4 4 3 0 0 0 0 3 3 3 0 0 0 0 0 0 4 4 4 4 0 0 0 0 0 4 4 4 4 0 0 0 0 4 0 0 0 0 4 3 5 5 5 5 4 
4 2 2 2 2 5 4 3 3 0 0 0 3 2 2 2 2 2 0 3 3 0 4 4 0 0 3 3 3 0 0 4 4 3 0 0 0 0 0 3 3 3 4 2 2 2 2 2 5 4 
4 6 6 6 6 6 5 5 3 0 2 2 2 2 6 6 6 2 2 2 3 3 0 4 0 0 3 2 2 2 2 4 2 3 3 0 0 0 4 4 4 4 2 2 6 6 6 2 2 6 
4 2 2 2 6 6 6 2 2 2 2 6 6 6 6 6 6 6 6 2 2 2 0 0 2 2 2 2 6 6 6 2 2 3 3 3 0 0 3 3 3 4 2 6 6 6 6 6 6 6 
4 3 3 2 2 6 6 6 6 6 6 6 6 6 6 6 6 6 6 6 6 2 2 2 2 6 6 6 6 6 6 6 6 2 2 3 0 3 3 3 2 2 6 6 6 6 6 6 6 6 
4 3 0 3 2 3 4 2 2 6 6 2 2 2 2 2 2 2 2 2 6 6 6 6 6 6 6 6 6 6 6 6 6 6 2 2 2 2 2 2 2 6 6 6 6 6 6 6 6 6 
4 0 0 3 3 3 4 0 2 2 2 2 3 0 0 0 0 0 0 2 2 6 6 6 6 2 2 2 2 2 6 6 6 6 6 6 10 6 6 6 6 6 6 2 2 2 6 2 2 6 
4 0 0 0 0 4 4 0 0 0 0 3 3 0 0 0 0 0 0 3 2 2 5 5 5 4 5 3 3 5 5 4 5 2 2 2 2 2 6 6 6 6 6 5 3 2 2 2 5 4 
4 0 0 4 4 4 4 4 4 0 0 0 0 0 0 0 0 0 0 3 3 3 5 4 4 4 4 0 3 5 4 4 4 0 0 0 3 2 2 2 2 2 5 4 5 3 5 5 5 4 
4 0 0 4 4 4 4 4 4 4 0 0 0 0 0 0 0 0 0 0 0 4 4 4 4 4 4 0 0 0 0 4 4 0 0 0 3 3 3 0 0 4 4 4 3 5 5 5 5 4 
4 0 0 4 4 0 4 4 4 4 0 0 3 3 3 3 0 0 0 0 0 4 4 4 4 4 4 0 0 0 0 4 4 4 0 0 0 0 0 0 0 4 4 4 3 3 5 5 5 4 
4 0 0 4 4 4 4 0 0 4 4 1 1 1 7 1 1 1 1 1 1 1 1 4 4 4 4 4 0 4 4 4 4 4 1 1 7 1 1 1 1 1 4 4 0 3 5 5 5 4 
4 0 4 4 4 4 0 0 0 1 1 1 12 12 7 12 12 12 12 12 12 12 1 4 4 4 4 4 0 4 4 4 0 1 1 12 7 12 12 12 12 1 1 4 0 0 3 5 5 4 
4 0 4 4 4 4 0 0 1 1 12 12 12 12 7 12 12 7 7 7 12 12 1 3 3 3 0 4 0 0 0 0 0 1 12 12 7 12 12 12 12 12 1 0 0 0 3 3 5 4 
4 3 0 0 0 0 0 1 1 12 7 7 7 7 7 12 12 12 12 7 12 12 1 3 4 0 4 4 0 0 0 0 0 1 12 12 7 7 7 7 7 7 7 0 0 0 0 3 5 4 
4 3 0 4 4 0 1 1 12 12 12 12 12 12 7 12 12 12 12 7 12 12 1 3 4 4 4 4 4 3 0 0 0 1 12 12 7 8 12 12 12 12 1 0 0 4 4 3 3 4 
4 3 0 4 4 4 1 12 8 12 12 12 12 12 7 12 12 12 12 7 12 12 1 0 4 4 4 4 4 3 0 4 4 1 1 12 7 12 12 12 1 1 1 0 0 4 4 4 3 4 
4 3 0 0 0 0 7 7 7 7 7 7 7 7 7 7 7 7 7 7 7 7 7 0 4 4 4 3 3 3 4 4 4 4 1 1 7 1 1 1 1 0 0 0 0 0 4 4 3 4 
4 0 0 0 0 4 1 12 12 12 12 7 12 12 7 12 12 12 12 8 7 12 1 0 4 4 4 4 3 4 4 4 4 0 0 0 0 0 0 4 4 4 4 0 0 0 0 0 4 4 
4 4 4 4 4 4 1 12 12 7 7 7 12 12 7 12 12 12 12 12 7 12 1 0 0 4 0 4 3 4 4 4 4 4 0 0 3 0 0 4 4 4 4 0 0 0 3 0 4 4 
4 4 4 0 0 0 1 1 1 1 1 7 12 12 7 12 12 7 7 12 7 12 1 0 4 4 0 4 0 4 4 4 4 4 0 3 3 0 0 4 4 4 4 0 0 0 3 0 0 4 
4 0 4 4 0 0 0 0 0 0 1 7 12 12 7 12 12 12 7 7 7 1 1 0 4 0 0 4 0 0 0 4 4 0 0 3 0 0 0 4 4 4 4 4 0 0 3 0 4 4 
4 0 4 4 0 4 0 4 0 0 1 7 12 12 7 12 12 12 12 1 1 1 0 0 4 0 4 4 0 0 0 4 0 3 3 3 0 4 4 4 4 4 4 0 0 0 3 0 4 4 
4 0 4 4 4 4 4 4 4 0 1 1 1 1 7 1 1 1 1 1 0 0 0 4 4 0 4 4 4 0 0 4 4 3 4 4 0 4 4 4 4 0 0 0 0 3 3 0 4 4 
4 0 4 4 4 4 4 4 0 3 4 4 4 4 0 0 4 0 0 4 0 4 4 4 4 0 0 4 4 0 0 0 0 0 4 4 4 4 4 4 4 4 4 4 3 3 0 0 4 4 
4 0 0 4 4 4 4 4 0 3 4 4 4 4 0 4 4 0 4 4 0 4 0 4 4 0 0 4 4 4 4 0 0 0 4 4 4 0 4 0 4 4 4 4 0 0 0 4 4 4 
4 0 0 0 0 0 3 3 3 3 3 0 0 0 0 0 0 0 0 0 0 3 3 3 3 0 0 0 0 0 0 0 0 0 0 0 3 3 3 3 3 3 3 0 0 0 0 4 4 4 
4 4 4 4 4 4 4 4 4 4 4 4 4 4 4 4 4 4 4 4 4 4 4 4 4 4 4 4 4 4 4 4 4 4 4 4 4 4 4 4 4 4 4 4 4 4 4 4 4 4
